********************************************************************************
*##############################################################################*
*##############################################################################*
*##############################################################################*
*#############################*################################################*
*#################################*****########################################*
*#################################*****########################################*
*#################################*****########################################*
*#################################*****########################################*
*#################################*****########################################*
*##############################################################################*
*##############################################################################*
*##############################################################################*
*##############################################################################*
*##############################################################################*
*#####################################################*########################*
*############################################################################***
*############################################################################***
*############################################################################***
*##############################################################################*
*##############################################################################*
*##############################################################################*
*##############################################################################*
*##############################################################################*
*##############################################################################*
*##############################################################################*
*####################################################################******####*
*####################################################################******####*
*####################################################################******####*
*##############################****##################################******####*
*##############################****##################################******####*
*##############################****##################################******####*
*##############################****############################################*
*##*###########################****############################################*
*##############################****############################################*
*##############################################################################*
*##############################################################################*
*##############################################################################*
*##############################################################################*
********************************************************************************
