********************************************************************************
*##############################################################################*
*##############################################################################*
*##############################################################################*
*##############################################################################*
*##############################################################################*
*##############################################################################*
*##############################################################################*
*##############################################################################*
*##############################################################################*
*##############################################################################*
*##############################################################################*
*##############################################################################*
*###################################***########################################*
*###################################***########################################*
*###################################***########################################*
*###################################***########################################*
*###################################***########################################*
*###################################***########################################*
*###################################***########################################*
*############################*****#############################################*
*############################*****#############################################*
*##***#######################*****##################################******#####*
*############################*****##################################******#####*
*################*###########*****##################################******#####*
*###################################################################******#####*
*##############################################################################*
*#######################################################*******################*
*#######################################################*******################*
*################################################*****#########################*
*################################################*****#########################*
*################################################*****#########################*
*##############################################################################*
*##############################################################################*
*##############################################################################*
*##############################################################################*
*##############################################################################*
*##############################################################################*
*##############################################################################*
********************************************************************************
