********************************************************************************
*##############################################################################*
*##############################################################################*
*##############################################################################*
*##############################################################################*
*###################***######################################****##############*
*###################***######################################****##############*
*############################################################****##############*
*############################################################****##############*
*############################################################****##############*
*############################################################****##############*
*##############################################################################*
*##############################################################################*
*##############################################################################*
*##############################################################################*
*##############################################################################*
*##############################################################################*
*##############################################################################*
*##############################################################################*
*##############################################################################*
*##################**##########################################################*
*##################**##########################################################*
*##############################################################################*
*##############################################################################*
*##############################################################################*
*##############################################################################*
*##############################################################################*
*##############################################################################*
*##############################################################################*
*############################################################################***
*############################################################################***
*############################################################################***
*########################################################*******#############***
*########################################################*******#############***
*########################################################*******#############***
*########################################################*******#############***
*###############################################*############################***
*############################################################################***
*##############################################################################*
********************************************************************************
