********************************************************************************
*##############################################################################*
*##############################################################################*
*##############################################################################*
*##############################****############################################*
*##############################****###########************#####################*
*##############################****##########*************################******
*##############################****##########*************################******
*############################################*************################******
*############################################*************#####################*
*############################################*************#####################*
*############################################*************#####################*
*######################*****#################*************#####################*
*######################*****#################*******###########################*
*######################*****############################################********
*######################*****############################******##########********
*######################*****############################******#################*
*#######################################################******#################*
*#######################################################******#################*
*#######################################################******########*########*
*#########################################**############******#################*
*#########################################**############******#################*
*#######################################################******#################*
*#######################################################******#################*
*#######################################################******#################*
*#########************##################################******#################*
*#########************#########################################################*
*#########************#########################################################*
*#########************#########################################################*
*#########************#########################################################*
*#########************#########################################################*
*#########************#########################################################*
*###########**********#########################################################*
*###########**********#########################################################*
*###########**********############################################*############*
*#################################################################*############*
*#################################################################*############*
*#################******##########################################*############*
*#################******#######################################################*
********************************************************************************
