********************************************************************************
*##############################################################################*
*##############################################################################*
*##############################################################################*
*##############################################################################*
*##############################################################################*
*##############################################################################*
*##############################################################################*
*##############################################################################*
*##############################################################################*
*##############################################################################*
*##############################################################################*
*##############################################################################*
*##########**##################################################################*
*##########**##############################################***#################*
*#######******#############################################***#################*
*#######******#############################################***#################*
*#######******#############################################***#################*
*#######******#################################################################*
*#######******#################################################################*
*#######******#################################################################*
*#######******#################################################################*
*#######******#################################################################*
*#######******###**############################################################*
*#######******###**#############*##############################################*
*#######******##***######**####################################################*
*###############***######**####################################################*
*#************###**############################################################*
*#************###**############################################################*
*#************#################################################################*
*#************#############################***#################################*
*##########################################***##########*******################*
*##########################################***##########*******################*
*##########################################***##########*******################*
*##########################################***##########*******################*
*########****##############################***##########*******################*
*########****##############################***##########*******################*
*########****##############################***##########*******################*
*######********############################***##########*******################*
********************************************************************************
